 # # # # #
 # . . . #
 . . # . #
 # . . . #
 # # # # #