 # # # # # # # # # # # #
 # . . . # . . . . . . #
 # . # . # . # # # # . .
 # # # . # . . . . # . #
 # . . . . # # # . # . #
 # # # # . # F # . # . #
 # . . # . # . # . # . #
 # # . # . # . # . # . #
 # . . . . . . . . # . #
 # # # # # # . # # # . #
 # . . . . . . # . . . #
 # # # # # # # # # # # #
